11111111111111111111
1C0E10000000000C0001
11001011000100000001
1001101C100101111001
1000001001C101C10001
10110010001101010101
1000000000000100P001
11111111111111111111