1111111111
1C10001E11
1000100001
1010101101
1P10C01C01
1111111111