111111
1E0011
111001
1000C1
1P1111
111111