1111111111111111111111111
1C00000000100000000000001
1011111110101111000000001
1010100010101C00010011001
1010001C101011010101C0001
1010111110101111010000111
10100000001000010100001E1
1010000111111100011110101
1010110000100000010000101
1000010000100000010C10101
1000010100000100110100001
100P00010C0000100C1000001
1111111111111111111111111